1111111111111111111111
1112112221112221111221
1122122200001200002221
1100000201101101102221
2211110202101101101221
2222120202201101101111
2221120102201101202221
1221110102100002102221
1211110001111222200011
1222111111111122221111
1122221111111111122222